%%%%%%%%%%%%%%%%%%%%%%%%%%%%%%%%%%%%%%%%%%%%%%%%%%%%%%%%%%%%%
%           %   %         % %     %   %     %              P%
% %%%%%%% %%% % % % %%%%% % % %%% % % % % % % %%%%%%%%%%%%%%%
%   %   % %   %   %     %   % % %   %   % % % %             %
%%% % % % % %%%%%%%%%%% %%% % % %%%%%%%%% %%% % %%%%%%%%% %%%
%   % % %   %         %   % %   % %     %     % %       %   %
% %%% % %%%%% %%%%%%% %%% %%%%% % % %%% %%%%%%% % % %%%%%%% %
% %   %   %   %     %   %     % %   % %         % % %     % %
% % % %%%%% %%% % % % %%%%% %%% % %%% %%%%%%%%%%% %%% % % % %
% % %     % %   % % % %   % %   % %   %           %   % % % %
% % %%%%% % %%% % %%% % % % % %%% % % % %%%%%%% %%% %%% %%% %
% %   %   %   % %   %   % % % %     % % %     % %   % % %   %
% %%%%% %%%%% %%% % %%%%% % % %%%%%%% % %%% % % % %%% % % %%%
%     %     %   % %     % % %   %   % %   % % % %     % %   %
%%%%% % %%% %%% %%%%% % % % %%% % %%% %%% %%% % % %%%%% %%% %
% %   % % %     %     % % %   % %     %       % % %     % % %
% % %%% % %%%%%%% %%% %%% % %%% % %%%%%%%%%%% % % % %%% % % %
% %   %   %         % %   % %   %   %       % % % %   %   % %
% %%% %%% %%%%%%%%% % % %%% % %%%%% % %%%%% % % % %%% %%%%% %
%   %   %           % %   % %     %   %   % % % %   % %   % %
% %%%%% %%% %%%%%%%%% %%% % %%%%% %%%%% % % % % %%% % % % % %
%     %   % %     %   %   % %   %   %   %   % % %   % % %   %
% % %%%%% % % %%% %%%%% % % % % %%% % %%%%%%% % % %%% % %%%%%
% %     % % %   %       % % % % %   % %       %   % % % %   %
% %%%%% % % %%% % %%%%%%% % % % % %%% %%%%%%%%%%% % % % % % %
% %   % % % % % % %     % %   %   % %   %       %   % %   % %
% % % % % % % % %%% %%% %%%%%%%%%%% %%% % %%%%% %%%%% %%%%% %
% % % % % % % % %   % % %     %       %   %   %     %     % %
% % % % % % % % % %%% % % % %%% %%%%% %%%%% % %%%%% % %%% % %
% % % %   % % %   %   %   %   %     %   %   %   %   %   % % %
% % % %%%%% % %%%%%%% %%%%%%% %%%%% % %%% %%%%% % %%%%%%% % %
% % %   %     %         % %   %   % % %   %   % %   %   % % %
% %%% % %%%%% % %%% %%% % % % % %%% % % %%% % % %%% % % % % %
%     %     % %   % % %   % %   %   %   %   % %   %   %   % %
%%%%%%%%%%% % %%%%% % %%% % % %%% %%%%%%%%%%% % %%%%%%% %%% %
%       %   % %     %     % % %   % %         %         %   %
% %%% %%% %%% % %%%%% %%%%% %%% %%% % % %%%%%%%%%%%%%%%%% % %
% % %     % %   %     %   % %   %     %   %       %     % % %
% % %%%%%%% %%%%% %%%%% % % % %%% %%%%%%% % % %%% % %%%%% %%%
% %             % %   % % %   % % %   % %   %   % % %   %   %
% % %%%%%%%%%%% % % % % % %%%%% % % % % %%%%%%% % % % % %%% %
% %   %       %   % % % % %       % %     % %   %   % % %   %
% %%% %%% %%% %%%%% % % % % %%%%%%% %%%%% % % %%%%%%% % % %%%
% % %   %   %     % %   % %     %     %   % % %       % %   %
% % %%% %%%%% %%% % %%%%% %%%%% % %%% % %%% % % %%%%%%% %%% %
% %   %     % % % % %   % %     % %   % %   %     %   %   % %
% %%% %%%%% % % % % %%% % % %%%%%%% %%% % % %%%%%%% % % % % %
%   %       % % %   %   % % %       %   % %     %   %   % % %
%%% %%%%% %%% % %%%%% %%% % %%%%% %%% %%%%%%%%% % %%% %%%%% %
%   %   %   %     %     %         %       %     % %   %     %
% %%% % %%% %%%%% %%%%% %%%%%%%%%%%%%%%%% % %%%%% %%%%% %%%%%
%     %   %     % %     %             % % % %     %     %   %
%%%%%%%%% %%%%% % % %%%%% %%%%%%%%%%% % % % % %%%%% %%%%% % %
%       %     % %   %   % %     %     %     %     %     % % %
% % %%%%%%%%% % %%%%% % % % %%% % %%%%%%%%%%%%%%% %%%%% % % %
% % %     %   %       %   % % % %       %       %     %   % %
% % % %%% % %%%%%%%%%%% %%% % % % %%%%% % %%%%% %%% %%%%%%% %
% %   % %   %           %   %   % %   %   %   %     %     % %
% %%%%% %%%%%%%%%%%%%%%%% %%% %%%%% % %%%%% % %%%%%%% %%% % %
%.                        %         %       %         %     %
%%%%%%%%%%%%%%%%%%%%%%%%%%%%%%%%%%%%%%%%%%%%%%%%%%%%%%%%%%%%%
