%%%%%%%%%%%%%%%%%%%%%%%%%%%%%%%
% %                          P%
% % %%%%%%%%%%%%%%%%%%%%%%%%%%%
% %   %     %       %   %     %
% %%% % % % % %%%%% % % % %%% %
%   % % % % % %   %   %   % % %
% % % % % %%% % % %%%%%%%%% % %
% % % % %     % %       %   % %
%%% % % %%%%%%% %%%%%%% % % % %
%   % %     %     %   %   % % %
% %%% %%%%% % %%%%% % % %%% % %
% %   %   % %   %   % % %   % %
% % %%% % % %%%%% %%% %%% % % %
%   %   % %     % % % %   % % %
% %%%%% % %%%%% % % % % % %%% %
% %     % %   %   % %   % %   %
% % %%%%% % % %%%%% %%%%% % %%%
%   %     % %   %         %   %
%%%%% %%%%% %%%%% %%%%%%%%%%% %
%   %   %         %   %   %   %
% % %%% %%% %%%%%%% % %%% % %%%
% %   %   %         %   % %   %
% %%% %%% % %%%%%%%%%%% % %%% %
% %   %   % %     %   % %   % %
% % % % %%% % %%% % %%% % %%% %
% % % %   % % %   %     %   % %
%%% %%%%% %%% % %%% %%%%%%% % %
%   %     %   %   %         % %
% %%% %%%%% %%%%% %%%%%%%%%%% %
%.          %                 %
%%%%%%%%%%%%%%%%%%%%%%%%%%%%%%%
