%%%%%%%%%%%
%     %  P%
% %%% % %%%
%   % % % %
%%%%% % % %
%     %   %
% %%%%%%% %
%   %     %
% % % %%%%%
%.%       %
%%%%%%%%%%%
