%%%%%%%%%%%%%%%%%%%%%%%%%%%%%%%%%%%%%%%%%%%%%%%%%%%%%%%%%%%%%%%%%%%%%%%%%%%%%%%%%%%%%%%%%%%%%%%%%%%%%
%   %     %     %   %                 %                 %               %   % %                    P%
%%% % %%% % %%% % % % %%%%%%%%% %%%%%%% %%%%%%%%%%% %%%%% %%%%%%% %%%%% % % % % %%%%%%%%%%%%%%%%%%%%%
%   %   % %   %   %   %       %     %   % %       % %     %   %   %   %   %   %   %         %       %
% %%%%% % %%% %%%%%%%%%%% %%% %%%%% % %%% % %%%%% % % %%%%% %%% %%% % %%%%%%%%%%% %%% %%% % % %%%%% %
%       %     %         % % %   %   %   %   % %   % % %     %   %   %           %   % %   % %     % %
% %%%%%%%%%%%%% %%%%% % % % % % % %%%%% % %%% % %%% % % %%% % %%% %%%%%%%%%%%%% %%% %%% %%%%%%%%% % %
% %   % %     %     % % % % % % % %     %   % % %   % %   % %     %   % %     %   %   %   %       % %
% % % % % % % %%%%%%% % % % % %%% % %%%%%%% % % % %%% %%% % %%%%%%% % % % %%% % %%%%% % % % %%%%%%% %
%   % %   % % %       % %   % %   %   %     % % %     %   %         %   %   %   %     % %   % %     %
%%%%% %%%%% % % %%%%%%% %%%%% % % %%% % %%%%% % %%%%%%%%%%% %%%%% %%%%% %%% %%%%% %%%%%%%%% % % %%%%%
%     %     %   %   %         % % %   % %     %           %   %   %   %   % %     %       % % % %   %
% %%%%% %%%%%%%%% % %%%%%%%%% % %%% %%% % %%% %%%%%%% %%% % %%% %%% % %%%%% % %%%%% % %%% % % % % % %
% %               %       %   % %   %   %   % %       %   % %   %   % %     % %     % %   % % %   % %
% % %%%%%%%%%%%%%%%%%%%%% %%% % % %%% %%%%% % % %%%%%%% %%% % %%% %%% % % %%% %%%%%%% % %%% % %%%%% %
% %     %           %   %   % % % % % %   % % %   %       % %   %   %   % %   %       % % %   %   % %
% %%%%% % %%% %%%%% % %%%%% %%% % % % % % % % %%% %%%%%%% %%%%% %%% %%%%% % %%% %%%%%%% % %%% % % % %
%     % % % % %   % %     %   %   %   % %   %   % %     % %       %   %   % %     %     %     % % % %
%%%%% % % % % % % % % %%% %%% %%%%% %%%%%%% %%% % % %%% % % %%%%%%%%% %%%%% %%%%% % %%%%% %%%%%%% % %
% %   % %   %   % % % %     %     %   %   %   % %   % % %   %       %   %   %     % %   %   %   % % %
% % %%% %%%%%%%%% % % % %%%%%%%%% %%% % % %%% % %%%%% % % %%% %%%%% %%% % %%% %%%%% % % %%% % % % % %
% %   %     %     % % %         %   % % %   % %       % % %   %       % %     % %   % %   %   %   % %
% %%% %%%%% % %%%%% % %%%%%%%%% %%% % % %%% %%%%%%%%% % %%% %%% %%%%%%% %%%%%%% % %%% %%%%%%% %%%%% %
%     %   %   %     % %       % %   %   % %   %   %   %       % %               % %   %     % %     %
% %%%%% % %%%%% %%%%% % %%%%% % % %%%%%%% %%% % % % %%%%%%%%%%% % %%%%%%%%%%% %%% % %%% %%% % % %%%%%
% %     %     %   % % %   %   % %             % %   %     %   % % %         % %   % %   % %   %     %
% % %%%%%%%%% %%% % % %%% % % % %%%%%%%%%%%%%%% %%%%% %%% % % % % % %%%%%%% %%% %%% % %%% %%%%%%%%% %
% % %       %     % %   % % % %     %           %     %   % %   % % %     %     %     %           % %
% % % %%%%% %%%%%%% %%% %%% % %%% % %%%%% % %%%%% %%%%% %%% %%%%% % % %%% %%%%%%% %%%%%%% %%%%% %%% %
% % % %   % %         %     % %   %     % %           %   % %   %   %   %   %   %   %   % %   %   % %
% % % % % % % %%% %%%%%%%%%%% % %%%%%%% % %%%%%%%%%%%%%%% % % % %%%%%%% % %%% % %%% % % % % % %%% % %
% % % % % %   % % %           % %     % %   %   % %       %   %   %   % %     %   %   % % % %   % % %
% % % %%% %%%%% % % %%%%%%%%%%% % %%% % %%% % % % % %%%%%%%%%%% % %%% % %%%%%%% %%%%%%% % %%%%% % % %
% % % %   %   % %   %       %   %   % %   %   %   % %         % %   % %     % %       % %       % % %
% % % % % % % % %%%%%%%%% % % %%%%% % %%% % %%%%%%% % %%%%%%% % %%% % %%%%% % %%%%%%% % % %%%%%%% % %
% % %   %   %   %       % % % %     %   % % %   %   % %   %   %   % %   %   %       %   % %       % %
% % %%%%%%%%%%% % %%%%% %%% % % %%%%%%% % %%% % % %%% %%% % %%%%% % % % % %%% %%%%% %%%%% % %%%%% % %
% %   %       % % %   %     %   %     % %     %   %   %   %     % %   % % %   %   %     % %     % % %
% %%% % %%%%% % % % % %%%%%%%%%%% % % % % %%%%%%% % %%% % %%%%% % %%%%% % % %%% % %%%%% % %%%%% %%% %
% %     %     % %   %   %     %   % % % % %     % % %   % %   % %     % % % % % %     %   %     %   %
% %%%%%%% %%%%% % %%%%% % %%% % %%% %%% %%% %%% %%% % %%% % % % %%%%% %%% % % % %%%%% %%%%% %%%%% %%%
%     %   %   % % % %   % % %   % % %   %   % %     %   % % % %     %     % % %   % %   %   %   %   %
%%%%% % %%% %%% % % % %%% % %%%%% % % % % %%% %%%%%%% % %%% % %%%%% %%%%%%% % %%% % %%% % % % % %%% %
%     % %       % % % %   %       % % % % %     %     % %   %     %       % %   % %   % % % % %   % %
% %%%%% % %%%%%%% % % % %%% % %%%%% % %%% % % %%% %%%%% % %%%%% % % %%%%%%% % % % % % % % %%% %%% % %
% % %   %     %   % % %   % % %     %     % % %   %   %   %   % % %         % %   % % % %   %   % % %
% % % %%%%%%% % %%% % %%% %%% % %%% %%%%%%%%% % %%% % %%%%% %%% %%%%%%%%%%%%% %%%%% % % %%% %%% % % %
% %   %     % % %   %         % %     %       % % % %     %   % %   %       % %   % % %   %   % %   %
% % %%%%% % % % % % %%%%%%%%%%% %%%%% %%%%% %%% % % %%% % % % % % % % %%%%% % % % %%% % %%% % % %%% %
% %       % % % % %     %       %   %     % %   %     % % % % %   % % %   %     %     % %   % %   % %
% %%%%%%%%% % % % %%% %%% %%%%% % % %%%%% % % %%% %%%%% %%% % %%%%% % %%% %%%%%%%%%%%%% % %%%%%%% % %
%   %       % % %   %   %   % % % %   %     %   %   %   %   % %     %     %   %         % %       % %
%%% %%% %%%%% % %%% %%% %%% % % % %%% % %%%%%%% % %%% %%% %%% % %%%%%%%%% % %%% %%%%%%%%% % %%%%%%% %
% %   % %     % %   %   %   % % %   % % %       % %   %     % %             %   %   %   % %     %   %
% %%% % % %%%%% %%%%% %%% %%% % %%% % %%% %%%%%%% % %%% %%%%% %%%%%%%%%%%%%%% %%% % % % % %%%%% % %%%
%   % % % %     %   %   %   %     % % %   %       %   %   %   %       %       %   %   %   %     %   %
% %%% % % %%%%% % % %%% %%% %%%%% % % % %%% %%%%%%%%% %%% % %%% %%%%% % %%%%%%% %%%%%%%%% % %%%%%%% %
% %   % % %   % % % %   % % %   % % %   % % %       %     %     %   % %   %   %     %     % %   %   %
% % %%% % % % % % % % % % % % % % % %%%%% % % %%% % %%%%%%%%%%%%% %%% %%% % % %%%%% % %%%%% % % %%% %
% % %   %   % %   %   % % %   % % % %       % %   % %         %   %   %   % %   %   %     % % %   % %
% % % %%%%%%% %%%%%%%%% % %%%%% %%% % %%%%%%%%% %%% %%%%%%% % %%% % %%% %%% %%% % %%%%%%%%% % %%% %%%
% % %       %       % %   %   % %   % %       %   %   %     %     %   %   %   % %   %     %   % %   %
% % %%%%%%% %%%%%%% % %%% % % % % %%% %%%%% % % % %%% % %%%%%%%%%%%%% %%% %%% % %%% % %%% %%%%% %%% %
% %       % %     % %     % % %   % %       % % %   %   %       %   %   %   % %   %   % %     %   % %
% %%%%%%% % % %%% % %%%%% % % %%%%% %%%%%%%%% % %%% %%% % %%%%% % % % % % %%% % %%%%%%% %%% % % % % %
% %       %   % % % %   % % %             %   % % % %   % %   %   % % % % %   % %         % % % % % %
% % %%%%%%%%%%% % % % % % %%%%% %%%%% %%% % %%% % % %%%%% %%% %%%%% % % % % %%% % %%%%%%% % % % % % %
% %     % %       % % % %     %   % %   % % %     %     %   %       % % %   % % %   %   % % % % % % %
% %%%%% % % %%%%%%% % % %%%%% %%% % %%% %%% %%%%%%% %%% %%% % %%%%%%% % %%%%% % %%% %%% % % % %%% % %
%       % % % %       %   %     %   % %       %   % %     % %   %     %       %         % % %   % % %
% %%%%%%% % % % %%%%%%%%% %%%%% %%% % %%%%%%% % % %%% %%% % %%% %%%%%%% %%%%% %%%%%%%%%%% % %%% % % %
% %   %     %   %     % % %   % %       %   %   %   %   % %   % %       %   %       %     %   %   % %
% % % % %%%%%%%%% %%% % % % % % %%%%%%%%% % %%%%%%% %%% %%%%% % % %%%%%%% % % %%%%% % %%% %%% % %%% %
%   % % %         %   % %   % %           %       %     %     % %     %   %   %   % % %     % % %   %
%%%%% % % %%% %%%%% %%% %%%%% %%%%%%%%%%% %%%%%%% %%%%%%% %%%%% % %%% % %%%%%%% % %%% %%% %%% %%% % %
%     % % %   %     %       %   %   %     %   %           %   % % %   % %       %   %   % %   %   % %
% %%%%% %%% %%% %%%%% %%%%% %%% % % % %%%%% % %%%%%%%%% %%%%% % %%% %%% % %%%%%%%%% %%% % % %%% %%%%%
% %   %     % %   %     % %   %   % %   %   %     %   % %   %       %   % %   %   %     % % %   %   %
% % % %%%%%%% %%% %%%%% % %%% %%%%% %%%%% %%%%%%% % % %%% % %%%%%%%%%%%%% % % % % % %%%%% % % %%% % %
% % %           %   %   %   %     % %     %   %   % %     % %           % % %   % % %   % % %   % % %
% %%% %%%%%%%%% %%% % %%% % % % %%% % %%%%% % % %%% %%%%%%% % %%% %%%%% % % %%%%% % % % %%% %%% % % %
%   %     %   % %   % %   % % % %   %     % %   %   %   %   %   % %   % % % %   % % % %       %   % %
%%% %%%%% % %%% % %%% %%%%% % %%% %%%%%%% % %%%%%%% % % % %%%%% %%% % % % % % %%% % % %%%%%%%%% %%% %
%   %     % %   % %         % %   %       %     %   % % %       %   % %   % %     % %     %   % % % %
% %%%%%%% % % %%% %%%%%%%%% % % %%%%% %%%%%%%%% % %%% % %%% %%%%% %%% %%%%% % %%%%%%%%%%% % % % % % %
% %     %   %   %     % %   % % %     %       %   %   %   % %     % %   %   %             % % %   % %
% %%% % %%% %%% %%%%% % % %%% % % %%%%% %%%%% %%%%% %%%%% %%% %%%%% %%% % %%% %%%%%%%%% %%% % %%% % %
% %   %   % % %       %     % % % %     %   %       %   %     %   %     %   % %   %     %   % %   % %
% % %%%%% % % %%%%%%%%% %%%%% % % % %%%%% %%%%%%%%%%% %%%%%%%%% %%% %%%%% % %%% % %%%%%%% %%% %%%%% %
%   %     %       %     %     % % %   %     %                 %   %   %   %   % %         %   %     %
%%%%% %%%%%%%%%%% %%%%%%% %%%%% % %%% %%% % % %%%%%%%%%%%%%%% % % %%% %%% %%% % %%%%%%%%%%% %%% %%% %
%   % %   %     %       %       %   %   % %   %       % %   % % %   %   %   % %     %       %   %   %
%%% % % % % %%% %%%%%%% % %%%%%%%%% %%% %%%%% % %%%%% % % % % % %%% %%% %%%%% %%%%% %%% %%%%% % %%%%%
%   %   % % %   %     % %           %   %   %   %   % %   % %   % %     %         %   %   %   %     %
% %%%%%%% % % %%% %%% % %%% %%%%%%%%% % % % %%%%% % % %%%%% %%%%% %%%%%%% %%%%%%%%%%% %%% % %%%%%%% %
%       % % %     %   %   % %         % % %       % % %                 % %   %       %   %       % %
% %%%%% % % %%%%%%% %%%%% %%% %%%%% %%%%% %%%%%%%%% % % % %%%%%%% %%%%% % % % % %%%%%%% %%% %%%%% % %
% %   % % %   %   % %         %     %   %   % %     %   % %   %   %   %   % % %   %   %   % %   % % %
% % % % % %%% % % % %%%%%%%%%%%%%%%%% % %%% % % %%%%%%%%%%% % %%%%% % %%%%% % %%% % % %%% %%% % %%% %
%.  % %       % %                     %     %               %       %       %     % %         %     %
%%%%%%%%%%%%%%%%%%%%%%%%%%%%%%%%%%%%%%%%%%%%%%%%%%%%%%%%%%%%%%%%%%%%%%%%%%%%%%%%%%%%%%%%%%%%%%%%%%%%%
