%%%%%
% %P%
% % %
%.  %
%%%%%
